#################
#G...#......#...#
#..P.#......#...#
#....#E.....##D#.#
#...O#..........#
######...O......#
#.E.E....S......#
#...............#
#...............#
#...............#
#...............#
#...............#
########........#
########.......O#
########........#
#KT###T#H......O#
#################
