#################
#G...#......#.X.#
#..P.#......#...#
#....#E.....##D##
#...O#..........#
######...O......#
#.E.E....S......#
#...............#
#...............#
#.......T.......#
#...............#
#...............#
########........#
########.......O#
########........#
#KT###T#H......O#
#################
