#########################
#X#.................#..P#
#.#.######..#########..O#
#.#.##...#..........#####
#.#.#...#..######..#.T.#
#.#.#...............#...#
#.#.................#...#
#.#####.............#...#
#.....#.................#
#.....#.................#
#...#.#.................#
#...#.#.................#
#...#.#.................#
#...#.#.................#
#...#.#.................#
#...#.#.................#
#...#.#.................#
#.......................#
#.......................#
#.......................#
#.......................#
#.......................#
#.......................#
#.......................#
#########################
